G0G0G0G0G0G0G0G0G0G0G0G0G0G0G0G0G0G0G0G0
G0G0G0G0G0G0G0W0W0G0G0G0G0G0N0G0G0G0G0G0
G0G0G0G0G0G0G0W0W0G0G0G0G0G0G0G0G0G0G0G0
G0G0G0G0T1G0G0G0G0G0G0G0G0G0G0G0G0G0G0G0
G0G0G0G0G0G0G0G0G0G0G0G0G0R0R0R0R0R0R0F0
G0G0G0G0G0G0G0G0G0G0G0G0G0R0G0G0G0G0G0G0
G0G0G0G0G0G0G0G0G0G0G0G0G0R0G0G0G0G0G0G0
G0G0G0G0G0G0G0G0G0R1R1R1R1C0R1R1R1R1R1F1
G0G0G0G0G0G0G0G0G0R1G0G0G0R0G0G0G0G0G0G0
S1R1R1R1R1R1R1R1R1R1G0G0G0R0G0G0G0G0G0G0
G0G0G0G0G0G0G0G0G0G0G0G0G0R0G0G0G0G0G0G0
G0G0G0G0G0G0G0G0G0G0G0G0G0R0G0G0G0G0G0G0
G0G0G0G0G0G0G0G0G0G0G0G0G0R0G0G0G0G0G0G0
S0R0R0R0G0G0G0G0G0R0R0R0R0R0G0G0G0G0G0G0
G0G0G0R0G0G0G0G0G0R0G0G0G0G0G0G0G0G0G0G0
G0G0G0R0G0G0G0G0G0R0T2G0G0G0G0G0G0G0G0G0
G0G0G0R0R0G0G0G0G0R0G0G0G0G0G0G0G0G0G0G0
G0G0G0N0R0R0R0R0R0R0G0G0G0G0G0G0G0G0G0G0
G0G0G0G0G0G0G0G0G0G0G0G0G0G0G0G0G0G0G0G0
G0G0G0G0G0G0G0G0G0G0G0G0G0G0G0G0G0G0G0G0